######################
#                    #
#                    #
#  ###############   #
#      #        #    #
#     S#        #    #
### ####    #   #    #
#      ##   #        #
#      #    #        #
#           ##########
#                  E #
######################