##########
#S       # 
######## #
#        #
# #      #
# #      #
# ########
#        #
#   ######
#       E#
##########