######################
#                    #
#                    #
#  ###############   #
#      #        #    #
#     S# ##     ###  #
# ######  # #   #    #
#      ## # #        #
#      #  # #        #
#      #  # ##########
#         #        E #
######################