##########
#S       # 
######## #
#        #
#        #
# #      #
# ########
#      #E#
#   #### #
#        #
##########